#######@#################################
#.......#...............#.........#.....#
#.#######.#########.#.#.#.#######.#.###.#
#.........#.......#.#.#.#.......#.#...#.#
#.#######.#.#.#####.#.###########.#.###.#
#.#.......#.#...#...#.#...........#.#...#
#.#######.#.#.#####.#.###########.#.#.#.#
#.........#.#.....#.#.....#.......#.#.#.#
###########.#.###.#.#.###.#########.#.#.#
#...........#...#.#.#...#.#.........#.#.#
#.###############.#.#####.#.#########.###
#.#.......#.....#.#.#.....#.#.......#...#
#.###.#.#.#.#.#.#.#.#.###.#.#.#########.#
#...#.#.#.#.#.#.#.#.#.#.#.#...#.........#
#.#.#.#.#.#.#.#.#.#.#.#.#.###.#.#########
#.#.#.#.#.#.#.#...#.#.#.#.#.#.#.........H
###.#.#.#.#.#.#...#.#.#.#.#.#.###########
#...#.#.#.....#.....#.#.#.#.#.#.........#
#.#####.#######.....#.#.#.#.#.#.#######.#
#.#.....#.............#...#.#.#.#.....#.#
#.#.#####.###############.#.#.#.#.###.###
#.#.....#...............#.#.#.#.#.#.#...#
#.#.#######.###########.#.#.#.#.#.#.###.#
#.#.#.....#.#.........#.#...#.#.#...#...#
#.#.#####.#####.#######.#.###.#.###.###.#
#.#.#.....#...#.#.....#.#.#.#.#.#...#.#.#
#.#.#####.#####.#######.#.###.#.###.#.#.#
#.#.#.....#...#.#.....#.#.#.#.#.#...#.#.#
#.#.#.###.#.#.#.#.###.#.#.#.#.###.###.#.#
#.#.#...#...#.#.#.#.#.#.#.#.#.#...#...#.#
#.#.###.#######.#.#.#.#.#.#.#.#.#####.#.#
#.#.....#.....#.#.#.#.#.#.#.#.#.....#.#.#
#.#######.###.#.#.#.#.#.#.#.#.#####.#.#.#
#.#.......#.#.....#.#.#.#...#.......#.#.#
#.#.#######.#######.#.#.#############.#.#
#.#.#.....#.#...#.....#.#.........#...#.#
#.#.#.#.#.#.#.#.#######.#.#####.#.#.#.#.#
#.#.#.#.#.#.#.#.........#.#...#.#...#.#.#
#.#.###.#.#.#.###########.#.#.#.#######.#
#.......#...#...............#.#.........#
#########################################