#######################@#######
#.....#.....#.........#.......#
###.#.#.###.#.###.###.#######.#
#...#...#.#.#.#...#.#...#...#.#
#.#######.#.#.#.###.###.#.#.#.#
#.#.......#.#.#.#.....#.#.#...#
#.#.#######.###.#.#.###.#.#####
#.#.......#.#...#.#.....#.#...#
#.#######.#.#.###.#######.#.#.#
#.#.....#.#...#.#...#...#...#.#
#.#.###.#.#####.###.#.###.###.#
#...#...#.........#.#.......#.#
#####.###.#####.###.#.#######.#
#.....#.#...#.#.....#.....#...#
#.#####.###.#.#########.###.#.#
#.#.#.....#.#...#.......#...#.#
#.#.#.....#.#...#.......#...#.#
#.#...#...#.#.......#.....#.#.#
#.#####.###.#########.#####.#.#
#.....#...............#.......#
#####H#########################