###@#################
#.#.........#.......#
#.#########.#.###.#.#
#...#.....#.#.#.#.#.#
#.#.#.###.#.#.#.#.#.#
#.#.#.#.#.#.#.#.#.#.#
#.#.#.#.#.#.#.#.#.#.#
#.#.#.#.#.#.#...#.#.#
#.#.#.#.#.#.###.#.#.#
#.#.#.#...#.#...#.#.#
#.#.#.#####.#####.#.#
#.#...#...#.#...#.#.H
#.#####.#.#.#.#.#.###
#.......#.#.#.#.#...#
#.#######.#.#.#.###.#
#.#.#.....#...#.#...#
#.#.#.#########.#.###
#.#.#...........#...#
#.#.###############.#
#...................#
#####################