###############################################################################
#@#.......#.......#.........#...........#.....#.................#.....#.......H
#.###.###.#####.#.###.#####.###.#####.###.###.#.#.#############.###.#.#####.#.#
#.....#.#.....#.#.....#...#...#.#...#.....#.#...#.#...........#...#.#.......#.#
#######.#####.#.#######.#.###.#.#.#####.###.#####.#.#########.###.#.###.#######
#...........#...#.......#...#.#.#.#...#.........#.........#...#...#.#...#.....#
#.#.#.###############.#####.#.#.#.#.#.#########.###########.#####.#.#.###.###.#
#.#.#.#...........#...#.....#.#.#.#.#.....#.....#.#.........#...#...#.#.....#.#
#.#.###.#######.#.#.###.#####.#.#.#.#####.#.#####.#.#######.#.#.###.###.#####.#
#.#.#.......#...#...#...#.....#...#.#...#.#.......#.#...#...#.#...#.#...#.....#
###.#.#######.#####.#####.#########.#.#.#.#######.#.#.#.#.###.###.###.###.###.#
#...#.#.......#...#.#...#.#.........#.#.#.......#.#...#.#...#.#...#...#.#.#...#
#.#.#.#.#.#####.###.#.#.#.#.#.#########.#######.#####.#.#####.#.###.###.#.###.#
#.#.#.#.#.#...#.#.....#...#.#.#.......#...#...#.#...#.#.......#.........#...#.#
#.###.#.#.#.#.#.#############.#.#####.#.#.#.###.#.#.#####.###########.#####.#.#
#.....#.#.#.#...#...#.........#...#.....#.#...#...#.....#.#.....#...#.#.....#.#
#.#####.#.#.#####.#.#.#.#######.#.#######.###.#########.#.#.#####.#.#.#.#######
#.#...#...#.#.....#.#.#.#...#...#.#...#.............#...#...#.....#.#.#.......#
#.###.###.#.#####.#.###.#.#.#.###.#.#.###########.###.#######.#####.#########.#
#...#...#...#...#.#...#...#.#.#.#...#.....#.......#...#...#...#...#.........#.#
###.###.#####.#.#.###.#####.#.#.#########.#########.###.#.#.###.#####.#.###.#.#
#.............#...#.........#...........#...............#...#...........#.....#
###############################################################################
