################################################################
#...........#..................................................#
#...........#..................................................#
#.@.........#..................................................#
#...........#..................................................#
#...........#..................................................#
#...........#..................................................#
#..............................................................#
#..............................................................#
#..............................................................#
#..............................................................#
#..............................................................#
#..............................................................#
#..............................................................#
#..............................................................#
#################################################################