################################################################################
#...........#..................................................................#
#...........#..................................................................#
#..@........#..................................................................#
#...........#.................................................................. 
#...........#..................................................................#
#...........#...#...............................................................#
#...........#..#...............................................................#
#...........#..#...............................................................#
#............#.................................................................#
#..............................................................................#
#..............................................................................#
#..............................................................................#
#..............................................................................#
#..............................................................................#
################################################################################